A. Gordon Pym	
A. Wolf	Wolfie
A	A'tla
Aa	Green Lantern of Space Sector 904
Aabur-Z	Aabur's Uniform
Aalok	
Aanonson, Doug	Douglas Aanonson
Aanonson, Edna	
Aanonson, Everett	
Aaron	
Aaron Bodine	
Aaron Burr	
Aaron Caldwell	
Aaron Cash	
Aaron Herbst	
Aaron Langstrom	
Aaron Preston	
Ab	
AB-99	
Abaddon the Destroyer	
Abariel	
Abbattoir	Arnold Etchinson
Abbot, Kyle	
Abby Holland	Abigail Arcane and Abby Cable
Abdul	
Abdul Smith	
Abdul the Arab	
Abe Crane	
Abe Gold	
Abel	
Abe Rothstein	
Abercrombie, Doctor	
Aberration	
Abigail Hunkel	Red Tornado and Ma Hunkel
Abin Sur	Green Lantern of Space Sector 2814
Ablamsky, Captain	
Able Crown	
Able Cuvier	
Abnegazar	
Abner	
Abner Sedgwick	
Abominable Snowman	
Abomination	
Abra Kadabra	Abhararakadhararbarakh (Citizen Abra)
Abraham	
Abraham Davis	
Abraham Dusk	Metropolitan and Bram Dusk
Abraham Lincoln	
Abraham Lincoln Carlyle	
Abraham Linkidd	
Abraham Ryan	
Abraham Ryan	HW-17
Abrams, Jay	Blue Jay
Abraxis	
Absin	
Absorbency Boy	Kirt Niedrigh
Abu Ll Kaf	
Abudah	
Abyss	
Abyssma	Red Lantern (space sector unknown)
Acacia	
Acantha	
Accasbel	
Access	Axel Morty Asher
Accordion King	
Ace	Bat-Hound
	Ace
	Ace
	Joker
	Ace
	Ace
Ace Archer	
Ace Atchinson	
Ace High	
Ace Logan	
Ace Morgan	Kyle Morgan
Ace of Space	Ace Egan
Ace of Spades	Colonel Rushmore
Ace of Spades	Ace of Spades
	Derek Reston
	Amos Fortune
	Ace of Clubs
	Ernie Clay
	Ace of Spades
Ace of Winchesters	Ace of Killers
Ace Ruggles	
Ace Storm	Sue Storm
Acheron	
Acheron, Lord	
Achilles	Achilles
	Achilles
	Achillies
Achilles Milo	Professor Milo
Achilles Warkiller	
Achmed	
Achmed Khareemali	
Acid Master	
Acidia	
Ackerson, Henry	
Ackerson, Henry (an alias)	Metallo
Ackert, Doctor	
Aclima	
Acolyte	
Acrata	Andrea Rojas
Acrobat	
Acrobat	
Acro-Bat	Walter Chase
Action Boy	
Acton, Joan	Guinevere
Actor	
Actuary	
Ada Baba	
Adam	Green Lantern of Space Sector 1055
	Adam
Adam Chase	
Adam Constantine	
Adam Grant	Adam Morgan
Adam Kent	
Adam Monroe	
Adam of Eternia	He-Man
Adam Orion	Hunter
Adam Stepnik	
Adam Strange	
Adam Stranger	
Adam Winterbourne	
Adam-One	
Adams, Chris	
Adams, Jeff	
Adams, Michael	Ogre
Adamson, Lee	
Adam-Stranger	
Adara	Green Lantern of Space Sector 62
Adara	
Adder	
Addie Vochs	Vox Populi
Adelbert Dribble	
Adele Knight	Adele Doris Drew
Adeline Wilson	H.I.V.E. Mistress (II)
Adiremi	
Adler	
Admiral Corby	
Admiral Grant	
Admiral Numa	
Admiral Spruance	
Admiral Strom	
Adolf Hitler	
Adonis	John Trevor
Adonis	
Adramelech	
Adrian, Myles	
Adrianna Tomaz	Isis
Advance Man	
Aegeus	Nikos Aegeus
Aella	
Aerialist	Otto Fisher
Aesop, Johnny	
Aethyr	
Aftermath	
Agamemno	
Agantha	
Aga'po	Queen Aga'po
Agares	
Agemo	
Agent !	Malcolm
Agent Arrhnyr	
Agent Axis	Sigrid
Agent Axis	
Agent Carmichael	
Agent Flashling	
Agent Graves	Philip Graves
Agent Healy	
Agent Ishikawa	
Agent Lee	
Agent Liberty	Ben Lockwood
Agent Morro	
Agent Orange	Larfleeze
	Agent Orange
	Todd Ritondero
Agent Rogers	
Agent T-21	Lita Laverne
Agent West	
Agent X-3	Dirk Folgar
Agnes Martinon	
Agni	
Agony	
Agua Sin Gaaz	
Ah Puch	
Ahab	
Ahasverus	
Ah-Choo	
Ahk-Orrd	
Ahk-Ton	
Ahmed	
Ahmed Samsarra	White King (I)
Ahmed the Great	
Ahti	Kismet
Ahtier	Green Lantern of Glazzon
Ahwehota, the Wind Runner	Max Mercury, Max Crandall, Quicksilver
Aida	
Ailsa	
Air	Gary Johnson
Air Wave	Lawrence "Larry" Jordan
	Harold "Hal" Jordan, a.k.a. Maser
	Helen Jordan
Airam Sappal	Green Lantern of Space Sector 1111
Airstryke	William Kavanagh
Aisha al-Fadhil	
AJ	Arthur Junior II
Ajax	Power Man, Wonder Man
Akarl	
Akhet the Star Smasher	
Akila	
Akins, Michael	
Akkqqus, Gallus Kon	Putnam Tane
Ak-Var	Flamebird
Ak-Var, Thara	
Al	
Al	
Al	
Al Beefer	Hog
Al Bizarro	
Al Desmond	Doctor Alchemy
al Ghul, Nyssa	Nyssa Raatko
al Ghul, Ra's	
al Ghul, Talia	Talia Head
Al Hatt	
Al Paca, Rash	
al Xu'ffasch, Ibn	
Alababa	
Alaktor	
Alan	
Alan	
Alan Armstrong	Spy Smasher
Alan Barnes	Brainstorm
Alan Davies	
Alan Dell	
Alan Kane	
Alan Ladd	
Alan Markham	
Alan Scott	Green Lantern, Sentinel andWhite King
Alan Windsor	
Alana Dominguez	
Alanash	
Alanna Strange	
Alaric the Goth	
Alba	
	
Albart of Ancinor	
Albert Einstein	
Albert Höllerer	
Albert M. Beezer	
Albert Martin	
Albert Rothstein	Nuklon, Atom Smasher
Albert the Artist	
Albert Van Cleef	
Alberto Falcone	
Albino Whale	
Alchemist	Element Lad
	Curtis Engstrom
Alcmaeon	
Alcana, Sonia	Batwoman
Aldain, Ben	
Alden, Fred	
Alden, Missus	
Aldrich Meany	
Aldrich, Thomas	
Ale	Ala, Ana
Alec	
Alec	
Alec Holland	Swamp Thing
Alec Holland	Swamp Thing
Aleea Strange	
Aleea Strange (Earth-22)	
Alesandra Taracon	Cucilla
Alessandra Fermi	Diva
Alex	
Alex	Alexander
Alex Damaskinos	Alexandra Damaskinos
Alex DeWitt	Alexandra DeWitt
Alex DeWitt	Green Lantern (alternate universe) and Alexandra DeWitt
Alex Greer	
Alex Merkel	Junior (II)
Alex Olsen	Swamp Thing
Alex Rinaldi	
Alex Trent	Bloodsport
Alex Yeager	
Alexander Allston	
Alexandra Allston	
Alexander Bannermain	
Alexander Burgess	
Alexander Cartwright	
Alexander Knox	
Alexander Luthor, Junior	
Alexander Luthor, Senior (Earth-3)	
Alexander Montez	
Alexander Nero	
Alexander the Great	
	
Alexander, Marla	
Alexander, Tony	
Alexandre LeRoi (Earth-19)	Master
Alexi Rasputin	
Alfie	
Alfie	
Alfie	
Alfred Beagle	
Alfred Pennyworth	Outsider
Alfred Pennyworth (clone)	
Alfred Stryker	
Alfy Twidgett	
Alger	
Algon	
Algor, Uli	
Ali	
Ali Ben Khadir	
Ali Krim	
Ali Rayner-West	Green Lightning
Ali, Muhammad	
Alia	Green Lantern of Space Sector 281
	Alia
Alias the Blur	Ilse Krauss
Ali-Baba	
Alibi Andy	
Alice	
Alice	Allie
Alice	
Alice Cable	
Alice Chilton	
Alice Cohen (I)	
Alice Cohen (II)	
Alice Herman	
Alice Jones	
Alice Pleasance	
Alice White	Alice Spencer
Alice Wired-for-Sound	
Alicia Hunt	
Alien (unnamed)	
Alien (unnamed)	
Alien X	
Alien-Ator	
Aliki Marceau	younger half of Double Dare
Alioso, Dominique	
Ali-Pasha, Mehmet	
Alisand'r	Green Lantern of Space Sector 2828
Alistair Bendel-White	
Alix	
All-American Boy	Joshua Taylor
Allan De Beaufort	Iron Man
Allard, Kent	The Shadow and Lamont Cranston
Alleahtha	
Allegro	
Allen Funt	
Allen Lane	
Allen, Barry	Flash (II)
Allen, Bart	Kid Flash (II) and Impulse (I)
Allen, Blaze	Speed Demon and Etrigan
Allen, Carrie	Flash
Allen, Crispus	Spectre
Allen, Dawn	one half of the Tornado Twins
Allen, Don	one half of the Tornado Twins
Allen, Edgar	
Allen, Gary	
Allen, Henry	
Allen, Iris West	Iris West
Allen, Jay	
Allen, Jake	
Allen, Lionel	Chaka Zulu
Allen, Myra	
Allen, Steve	
Allen, Ted	
Allen, Tommy	
Allen, Woody	
Allen, Woodley	
Allergent	Maxwell Veezey
Allerton, Carlyle (an alias)	Lex Luthor
Alley Cat	
Alley Cat	She-Cat and Cassandra Cartland
Alley-Kat-Abra	Felina Furr
Allison	
Allison Armitage	
Allison Chandler	
Allnut, Harold	
Allon, Gim	Colossal Boy
Allon, Marte	
Allon, Yera	Chameleon Girl and Shrinking Violet (II)
Alloy	
Allura	
Allura Zor-L	Allura In-Z
Allure	Damara Sinclaire
Ally Babble	
Alma Wilson	Alma Barnes
Alonzo Dulak	
Alonzo Kroll	
Alpanu Lasas	
Alpha	
Alpha	Michael Sommers
Alpha Centurion	Marcus Aelius
Alpha, the Experimental Man	
Alpha-Domino-5	Superboy Robot
Alpha-Red	
Arkadin, Nina	
Alpheus Hyatt	
al-Rashid, Harun	
Alsind	A'sinda
Alter	Adam Kroft
Althera	
Aluminum	
Alura Zor-El	Alura In-Ze
Alva Xar	
Alvarez, Carlos	Cougar
Alvarez, John	Doctor Mayavale
Alvin	
Alvin Draper	Tim Drake
Alvin Fitch	
Alvin Lashky	
Alvin Mann	Wanda
Alvin's mom	
Alyce	
Alyx Florin	Rose Canton and Thorn
Alyz	
Alzetti, Frank	
Amacost, Richard	
Amadan-na-Briona	
Amadeus Arkham	
Amalak	
Amalgam	Doc Bundy
Amanda	
Amanda Mason	Ransak (II)
Amanda McCoy	
Amanda Quick	
Amanda Spence	
Amanda Waller	Queen (I), White Queen (II), Black King (II) and Mockingbird (IV)
Amanita	Green Lantern of Space Sector 3100
Amateras	
Amaze	
Amazing Allegro	Anton Allegro
Amazing Ant	
Amazing Farads	
Amazing Grace	
Amazing Man	Lex Luthor
Amazing Man	William "Will" Everett I
Amazing Man	Will Everett III
Amazing Man	Markus Clay
Amazing Ronnie	
Amazing Vargas	
Amazing Wombat-Man	Maxwell Lord
Amazo	
Amazon	
Amazon Princess	
Amazoo	
Ambassador Choux	
Ambassador Jeryl	
Amber	
Amber	
Amber LeRoux	Ditto
Ambrose Bierce	
Ambush Bug	Irwin Schwab
Ame Okumura	
Ameeba, Doctor	
Amelia Hunkel-Jibbet	Sisty Hunkel
Amenadiel	
Amen-Hotep	
Amentep	Ibis the Invincible and Prince Amentep
American Eagle	Johnny Jingo
American Scream	Wizor
America-Smasher	
Americommando (I)	Tex Thompson
Americommando (II)	
Americommando (III)	
Americommando (IV)	David
Amery, Jay	
Ames	
Amethyst, Princess of Gemworld	
Amir	
Amnee Pree	Green Lantern of Space Sector 35
Amok	
Amon Hakk	
Amon Sur	
Amon Tomaz	Osiris
A'monn A'mokk	
Amon-Ra	
Amor	
Amorpho	
A-Mortal	
Amos	
Amos Amster	
Amos Baker (an alias)	Butcher and John Butcher
Amos Dunn	
Amos Fortune	Ace of Clubs
Amos Goodwin	
Amos Love	Benjamin Love
Amos Rexford	
Amos Sharkey	
Amouse	
Ampa Nnn	Sinestro Corpsman of Space Sector 3517
Amun	
Amun-Ra	
Amy	Chain Lightning and Amber
Amy	
Amy Ames	
Amy Beddoes	Barbara Gordon
Amy Beitermann	
Amy Rohrbach	
Amy Southern	Trauma
Amygdala	Aaron Helzinger
Anahid	
Anaïs Arcane	
Anakronus	
Anamede	
Anansa	Spider Queen
Anansi	
Ananze	James Thurlow
Anarchist	Simon Elis
Anarky	Lonnie Machin and Moneyspider
Anastasia Force	
Anathema	
Anatol Mykros	
Anatole	
Anatole Balzac	
Anatoli Feodorovitch Kalunnin	Yerosha
Anaya	
Andante	
Andar Pul	
Anders, Billy	
Anders, Gloria	
Anders, Harry	
Anderson, Becky	
Anderson, Claire	
Anderson, Geoffrey	
Anderson, Miss	
Anderson, Mitch	Outburst
Anderson, Officer	
Anderson, Professor	
Andi Kasinsky	
André	
Andre	
Andre	
André Blanc-Dumont	
Andre Buquet	
André Chavard	Pierre
Andre Choi	
André LeBlanc	
André Sinclair	Destroyer
Andrea	
Andrea	
Andrea	
Andrea Allen	
Andrea Beaumont	Phantasm
Andrea Lencioni	
Andrea Martinez	Comet
Andrea Thomas	Isis
Andrew	
Andrew Bates	
Andrew Bennett	
Andrew Goldman	
Andrew Jones	Comet
Andrew Nolan	Ferro Lad
Andrew Vinson	
Andrews	
Andrews	
Andrews, King	Michael Andrews
Andromache	
Andromeda	Laurel Gand
Andros	
Andy	
Andy Flint	
Andy Handy	
Andy Howe	Andrew Howe
Andy Kelly	Andrew Kelly
Andy Novak	
Andy Parsons	
Aneuteloi	
Ang, Rachel	
Angago, Captain	
Angark	
Angel	
Angel Devilin	Angel Deviln
Angel Killer	August Davezak
Angel Love	
Angel Lupo	
Angel McDunnagh	
Angel O'Day	
Angel the Wonder Cat	
Angel, Lucinda	
Angel, Mark	
Angel, Matthew	
Angela Blake	
Angela Blake (clone)	Angela Blake Luthor
Angela Margolin	
Angela Eiling	Angela Adam
Angela Revere	
Angelica	
Angelica	
Angelica Blaze	Blaze
Angelica's mother	
Angie	
Angie	
Angie	
Angie Ciccerone	
Angie Graham	
Angie Spatchcock	Angela Spatchcock
Angle Man	Angelo Bend
Angles Bigbee	
Angon	
Angus Running Deer	
Anima	Courtney Mason
Animal	Alberto Tontini
Animal Lad	Ennis Janhson
Animal Man	Bernhard "Buddy" Baker and A-Man
Animal-Vegetable-Mineral Man	Sven Larsen
Animus	
Anissa Dorsey	
Anita Fite	Empress
Anita Soulfeeda	
Ann Blyth	
Ann Gordon	Blondy Gordon
Ann Martin	
Ann V. Tran	
Anna	
Anna Erdel	
Anna Nagel	
Anna Ramirez	
Annataz Arataz	
Annabelle Langois	
Anne	
Anne Flaherty	
Anne Hathaway	
Anne-Marie	
Anne-Marie Vere	
Annette	
Annetta Kaplan	
Annette Devere	
Annie	
Annie	
Annie Cassidy	
Annie Fletcher	Bonfire
Annie Mojo	
Annie Oakley	
Annihilate	
Annihilator	Karl Keller and One-Punch Kid
Annihilator	Kenneth Anderson
Annihilator 171	John Flint
Annihilator, Junior	Pocketbook Pete
Annova, Boss	
Anointed One	
Anomalie	
Anomaly	Clone of Floyd "Bullets" Barstow
Ansari, Nur	
Answer	Mike Patten
Answer Man	Genius Jones
Answer Man	Bob Rozakis
Ant	Eddie Whit
Antaeus	
Antaeus	Mark Antaeus
Antagon	
Antagonist	
Antelope Boy	Feets
Antennae Lad	Khfeurb Chee Bez of Grxyor
Anthis	
Anthony	
Anthony Burke	Tony Burke
Anthony Dragio	
Anthony Garcia	
Anthony Lupus	Werewolf
Anthony Mantegna	Tony Mantegna
Anthony Rodriguez (I)	Big Words (I)
Anthony Rodriguez (II)	Big Words (II)
Anthony Romulus	Werewolf
Anthony Zucco	Tony Zucco, Boss Zucco and Fats Zucco
Anthony Zucco	Tony Zucco and Billy Marin
Anthro	
Anthrop	
Anti-Fate	Benjamin Stoner
Anti-Lad	
Anti-Lad's father	
Anti-Life Entity	Anti-Life Aspect(s)
Anti-Matter Man	
Anti-Matter Man II	
Anti-Monitor	
Antimony	Debbie Walker
Antinoos	
Antiope	
Antipathy	Red Lantern (space sector unknown)
Antiphon	
Antithesis	
Ant-Man	Jumbo Carson
Antoine	
Anton Arcane	
Anton Arcane	
Anton Arcane's secretary	
Anton Falenni	
Anton Geist	
Anton Halkor	
Anton Hastor	Hath-Set
Anton Knight	Nightslayer, Night-Thief
Anton Kraft	
Anton Relnic	Ambassador Relnic
Anton Sarrok	
Anton, Doctor	
Antonia	Tony
Antonio	
Antonio (Earth-19)	
Antonio Diego	Bane
Antonio Stefanacci	
Anu	
Anubis	
Anwar Madrid	
Anya Savenlovich	Green Lantern of Space Sector 2814
Anzus	
Apache Chief	
Aparo, Jim	
Ape	
Ape	
Apeface	
Aphrodite	
Apollo	Phoebus Apollo, Apollon
Apollo	
Apollo	Ray Summers
Apollo, Sonny	
Apophis	Apep
Appa Ali Apsa	Old-Timer
Apparition	Tinya Wazzo
Apparition (Post Zero Hour)	Tinya Wazzo
Appleton, Vincent	
April	
April Corso	
April Marigold	
April O'Day	
Apros	Green Lantern of Space Sector 3
Aq, Xola	White Witch, Mysa Nal, Hag, Jewel and Black Witch
Aquababy	Arthur Curry Jr.
Aquaduck	
Aquagirl (I)	Lisa Morel
Aquagirl (II)	Selena
Aquagirl (III)	Tula (I)
Aquagirl	Tula (II)
Aquagirl (IV)	Lorena Marquez
Aquagirl	Marina
Aqualad	Garth
Aqualad (853rd century)	
Aquaman	Arthur Curry, Orin and Aquaboy
Aquaman (II)	Arthur Joseph Curry
Aquaman (853rd century)	
Aqua-Man	Prince Namor
Aquamaria	
Aquamrine. Lord	
Aquarius	
Aquista, Darla	Warlock's Daughter and Laura Fell
Aquista, Henry	
Ar	
Ar Rheon	
Arabela	
Arak, Son Of Thunder	Arak Red-Hand
Arak	Arak Wind-Walker
Aram Al Ashir	
Aramis	
Aramouse	
Arani Desai	Celsius
Araquel	
Arashi Ohashi	
Arathaza	Barbara Kowaleski
Arawn Pen Annuvin	
Arbagast, Dean	
Arbutus	
Arch	
Arch Asher	
Archer	Quigley
Archer	
Archer Braun	
Archie	
Archie Atkins	
Archie Evergreen	
Archie Jones	
Archie Norton	
Archie O'Toole	
Archmage	
Archon Z'Gmora	Green Lantern of Cygnus
Archor the Sustainer	Archorivvon
Arcimboldo	
Arclight	Noah Pasternetti
Ard Rennat	
Ardeen, Imra	Saturn Girl and Imra Ardeen Ranzz
Ardeen, Kayla	
Arden, Ken	High Life
Ar-Diamphos	
Ardora Luthor	Ardora of Lexor
Ardora Luthor	
Arella	
Ares	Mars
Ares Bandet	Green Lantern of Space Sector 2167
Ares Buchanan, the Warmaster	Aristotle Buchanan
Aresia	
Argalia	
Argent	Toni Moretti
Argh!yle!	
Argus	
Argus	
Argus	Nick Kovak and Nick Kelly
Ari	
Ariadne	
Ariadne	
Ariadne	
Ariana Dzerchenko	
Ariel	
Aries, Eve	Saturn Queen
Arin Sur	
Arin the Armored Man	
Arion, Lord of Atlantis	
Arisia Rrab	Green Lantern of Space Sector 2815
Aristeas	
Aristotle Rodor	Tot
Arizona	
Arizona Raines	Arizona Ames
Arjowr	
Arkadin, Irena	
Arkadin, Nina	
Arkadin, Sofia	
Arkady Duvall	
Arkanonne	
Arkham, Elizabeth	
Arkham, Jeremiah	
Arkillo	
Arkkis Chummuck	Green Lantern of Space Sector 3014
Arl	
Arlayn	
Arlik, Condo	Chemical King
Arm Fall Off Boy	
Arma Getten	
Armageddon	
Armageddon Creature	Doomsday and the Ultimate
Armand Krol	
Armand Lydecker	Vulture and Army Lydecker
Armando	
Armando Ramos	
Armbruster	
Armek	
Armitage, John	
Armorbeast	
Armodillo	
Armorr, Val	Karate Kid
Armorr, Valentina	
Armory	Jim Tate
Armstrong, Helen	
Armstrong, Lieutenant	
Armstrong, Senator	
Armstrong, Shark	
Arn, Karth	
Arn, Val	
Arngrim, J. Robert	
Arngrim, J. Robert (clone)	
Arnie	
Arnie	
Arnie Carter	
Arno, Gustav J.	
Arnold	
Arnold	
Arnold	
Arnold Rundle	
Arnold Ballenger	
Arnold Burnsteel	Arnie Burnsteel
Arnold Flass	
Arnold Pruett	Shockwave
Arnold Stromwell	
Arnold Wesker	Ventriloquist
Arnold, Beneduck	
Arnold, Benedict	
Arnold's wife	
AR-N-O-Q	Green Lantern of Space Sector 1287
Arn-Ul	
Arrah, Jan	Element Lad
Arrakhat	
Arriachnon	Misty Kilgore
Arrowcaster	
Arrowette	Suzanne "Cissie" King-Jones
Arrowette	Bonnie King
Arsenal	
Arsenal	
Arsenal	Nicholas Galtry
Arsenal	Roy Harper
Arsenal (853rd century)	
Arsenic the Giraffe	
Arson Fiend	George D. Tweedle
Arsonist	
Art	
Art Borley	
Art Chase	
Art Saddows	
Art Shaler	
Artemis	Diana
Artemis Crock	Tigress
Artemis of Bana-Mighdall	
Artemis	
Artemisty Knight	Dial H.U.S.K., Paige Guthrie, Wonder Girl, Polaris, Mary Marvel Girl
Artemiz	Artemis
Arthro	
Arthur	
Arthur Curry	Tom Curry
Arthur Hall	James Jim Hall
Arthur Kendrick	
Arthur Kliburn	
Arthur Parrish	
Arthur Pemberton	
Arthur Pendragon	King Arthur
Arthur Reeves	
Arthur Swenson	
Arthur Villain	
Arthur Youngblood	
Artie	
Artin	
Artis Chep	
Artros	
Arum	
Aruna Shende	
Arux	
Arvese	
Arvor	
Arx	Green Lantern of Space Sector 488
Arzaz	
Asa	
Asa Ezaak	Momentus
Asano Nitobe	
Ash	Green Lantern of Space Sector 650
Ash Walker	
Ashbury Armstrong	
Ashe, Jacob	
Asherman, Oscar	
Ashiya	
Ashley Zolomon	Ashley Fox
Ashos	Doctor Mist
Ash-Pak-Glif	Green Lantern
Ashtopeth	
Asmodel	
Asmodeus	
Asmodon	
Asp, Benedict	
Assassin	Jonathan Drew
Assistant District Attorney Samuels	
Astarte	Diana (Hippolyta's sister)
Astarte	
Asteria	
Asteroth	
Astor, J.P.	
Astor, Mister	
Astor, Myke-4	Echo
Astorr	Infinity-Man
Astra	
Astra Logue	
Astra, Girl of the Future	
Astralad	Joseph Silver
Astro	
Astro	Bruce Mills
Atalanta	
Aten	
Aten, Supreme God of the Sun	
Athena	Pallas Athena
Athena	Celia Kazantkakis
Athleta	
Athos	
Athyns Of Karakann	
Atinai	Atinai the Pure, Atinai the Builder
Atkins, Charlie	
Atkins, Gwen	
Atlan	
Atlanna	
Atlas	Marzosh
Atlas	
Atlas	
Atli	Etzel
Atmos	
Atom	Albert "Al" Pratt
Atom	Ray Palmer
Atom	Adam Cray
Atom	Ryan Choi
Atom (853rd century)	
Atom Blake, Boy Wizard	Stuart Blake
Atom Detective	
Atom Man	Lex Luthor
Atomic Knight	Gardner Grayle
Atomic Skull	Albert Michaels
Atomic Skull	Joseph Martin
Atomic-Man	Paul Strobe
Atom-Master	
Aton	
Aton	
Aton Gissark	
Ator	Green Lantern
Atreides, Olympia	
Atro	
Atrocitus	Red Lantern of Sector 666
Atropos	
Attila	George Crystal
Attila-5	
Attu	
Atum-Ra	
Auberon	
Aubrey James	
Auden Post	
Audrey Lee	
Augera	
Augie	
August Durant	Mockingbird
August Ferril	
August General in Iron	Fang Zhifu
Augustine, Doctor	
Augustus	Octavian
Augustus Medici	
Aunt Bloodwyn	
Aunt Etta	
Aunt Harriet Cooper	
Aunt Mary	
Aunt Minerva	
Auntie Gravity	
Auntie Ruth	
Aura	Lindsay Wah
Aurakles	
Aurelius Boch	
Auron (I)	Lambien
Auron (II)	
Aurora	
Aurora	
Aurora	
Aurora	
Automan	Otto
Automaton	Robotman and Cliff Steele
Ava	
Avatar	
Avatar	Tiger
Aven	
Avenger	
Avery Dunham	
Avery H. Sunderland	
Avia	
Avia	
Aviator	
Aviax	Ornitho
Avir	Green Lantern of Rhoon
Avis	
Awkwardman	Leander Brent
Awn the Blink	
Axe	
Axel Nagel	
Axel Storm	Brain Storm
Axel Foley	
Axe-Man	
Axis	
Axis Amerika (I)	
Axis Amerika (II)	
Ayla Ranzz	Lightning Lass, Light Lass, Spark
Ayria	Green Lantern of Aegri Somnia
Ayrn the Underlord	
Azar (I-III)	
Azarathea	
Azazel	Abomination
Azeveda, Josh	
Azgore	
Azmodus	Spectre
Azrael	
Azrael	Jean-Paul Ludovic Valley
Azrael	Jean-Paul Valley, Junior andBatman
Azrael (protege of Jean-Paul Valley)	
Azrael	
Azrael (853rd century)	
Azrael	Michael Lane
Azraeuz	
Az-Rel	
Aztar	Spectre
Aztek	Uno and Curtis "Curt" Falconer
Aztek	
Azure	
